1111  11
10  0101
11100  1
110  0N1
111   11   1
