1111  11
10  0101
11100  1
110  01

111   1
