NO ./imgs/wall.xpm
WE ./imgs/wall.xpm
SO ./imgs/wall.xpm
EA ./imgs/wall.xpm
F 220,30,0
C 22,0,30



111111
100101
101001
1100N1
111111
