111111
100101
1F1001
1100N1
111111
