NO ./imgs/wall2.xpm
WE ./imgs/glass.xpm
SO ./imgs/bookshelf.xpm
EA ./imgs/wall.xpm
F 220,30,0
C 22,0,30



1111111111
1001000001
1010000001
1100N00011
100000011
1111111111
