NO ./imgs/wall.xpm
WE ./imgs/wall.xpm
F 220,30,0
SO ./imgs/wall.xpm
EA ./imgs/wall.xpm
C 225,30,0




        1111111111111111111111111
        1000000000110000000000001
        1011000001110000000000001
        100100000000000000N000001
111111110110000011100000000000011
100000000011000001110111111111111
11110111111111011100000010001
11110111111111011101010010001
11000000110101011100000010001
10000000000000001100000010001
10000000000000001101010010001
11000000110101011111010100001
11110111 1110101 101111010001
11111111 1111111 111111111111
