NO ./imgs/wall2.xpm
WE ./imgs/wall.xpm
SO ./imgs/wall2.xpm
EA ./imgs/wall.xpm
F 220,30,0
C 22,0,30



11111111
10010001
10100001
1100N001
10000001
11111111
