NO ./imgs/waterf2.xpm
WE ./imgs/lavaf2.xpm
SO ./imgs/waterf2.xpm
EA ./imgs/lavaf2.xpm
F 32,32,32
C 204,255,255



11111111111111111111111
10000000000000000000001
10000000000000000000001
10000000000000000000001
10000000000000000000001
10000000000100000000001
10000000000000000000001
10000000000000000000001
100000000000000000000N1
1111111111111111111111
