NO ./imgs/wall2.xpm
WE ./imgs/glass.xpm
SO ./imgs/bookshelf.xpm
EA ./imgs/wall.xpm
F 220,30,0
C 22,0,30



11111111
10010001
10100001
11000001
100000N1
11111111
